########E#######
#          #   #
# ###### ### # #
# ##   #  ## # #
#    #  ##     #
#  # ######## ##
#  #   S       #
################
