########E#######
#.........,#...#
#.######.###.#.#
#.##...#..##.#.#
#....#..##.....#
##.#.########.##
##.#...S.......#
################
