########E#######
#          #   #
# ###### ### # #
# ##   #  ## # #
#    #  ##     #
## # ######## ##
## #   S       #
################
